##################   ####################
################## H #######      ###   #
################## 1 #######            #
#######       ##### ########      ###   #
#######       ##### ########      #######
#######                           #
################### #########   ###
################### #########   #########
#              #### #########   #########
#              #### #######       #######
#              #### ####             #############
#  ################ ####             ####        #
#  ################                               #
#  ################                               #
#  ################ ####             ####        #
#                   #####           ##############
#                   ########     ########
#########################################