##############
#   #   ###  #
# ####  ##  #
#   #  ##  #
### # ##  #
#         #
###########